l- l- l- w- wf wf w- l- l- l- w- w- w- wt l-
l- lD l- l- wf wf wy l- l- w- w- wt w- l- l-
l- l- l- w- w- w- wt wy lB w- w- w- w- l- l-
l- l- l- l- w- w- w- w- w- wf w- wt lA l- l-
wf l- l- l- l- w- w- w- wf wf wy w- l- l- l-
wf l- lB l- lA w- wy wy w- w- w- lA l- l- l-
wf w- l- l- l- lA w- w- w- w- w- lA l- w- w-
w- w- w- l- lA w- wf w- wy w- w- w- w- w- w-
w- w- w- w- w- wf wf w- w- w- w- w- w- wf wf
lT l- w- w- w- w- w- w- l- l- l- l- w- w- w-
